NO ./assets/textures/xpm/CRATE_2L.xpm
SO ./assets/textures/xpm/BRICK_1A.xpm
WE ./assets/textures/xpm/BRICK_2A.xpm
EA ./assets/textures/xpm/CONCRETE_1A.xpm

F 189,195,199
C 236,240,241

        1111111111111111111111111
        1000000000000000000000001
        1011000000000000000000001
        1001000000000000000000001
        1001000000000000000000001
        1001000000000000000000001
        1001000000000000000000001
111111111011000000000000000000001
100000000011000001110111111111111
11110111111111011100000010001
11110111111111011101010010001
11000000110101011100000010001
10000000000000001100000010001
100000000000000011010100D0001
11000001110101011111011110N0111
11110111 1110101 101111010001
11111111 1111111 111111111111