NO ./assets/textures/labo/xpm/0.xpm
SO ./assets/textures/labo/xpm/1.xpm

F 189,195,199
C 236,300,241
WE ./assets/textures/labo/xpm/2.xpm
EA ./assets/textures/labo/xpm/3.xpm

            
        1111111111111111111111111
        1000000000110000000000001
        1011000000110000000000001
        10010000000D0000000000001
111111111011000000110000000000001
10000000001100000111D111111111111
11110111111111011100000010001
11110111111111011101010010001
11000000110101011100000010001
110000000000000011000000D0001
11000000000000001101010010001
11N00001110101011101111000001
11110111 1110101 101111010001
11111111 1111111 111111111111
  
1
