WE ./assets/textures/default/xpm/2.xpm
F 189,195,199
EA ./assets/textures/default/xpm/3.xpm
C 236,240,241

SO ./assets/textures/default/xpm/1.xpm
NO ./assets/textures/default/xpm/0.xpm

        1111111111111111111111111
        1000000000110000000000001
        1011000000110000000000001
        10010000000D0000000000001
111111111011000000110000000000001
10000000001100000111D111111111111
11110111111111011100000010001
11110111111111011101010010001
11000000110101011100000010001
100000000000000011000000D0001
10000000000000001101010010001
110000011101010111011110S0001
11110111 1110101 101111010001
11111111 1111111 111111111111