NO ./assets/textures/xpm/CRATE_2L.xpm
SO ./assets/textures/xpm/BRICK_1A.xpm
WE ./assets/textures/xpm/BRICK_2A.xpm
EA ./assets/textures/xpm/CONCRETE_1A.xpm

F 189,195,199
C 236,240,241
                      
                            1111111111111
     111111                 1000000000001
     100001      1111111111110000000000011111
     1000011     1000000000010000000000010001
     1000001     10000000000D00000000000D0101
     1000001     1000000000010000000000010001
     111D1111111 1000111111110000000000011111
     10000000001 10001      1000000000001
     1000000000111000111    111111D111111
     1000000000100000001        10001
     1000000000D00000011        10001
     1000000000100000001        10001
111111000000000111111111        10001
1000110000000001                10001
1000111111D11111           1111 1000111
10001   10001              100110000001
11D11   10001              1001 1000111
1000111110001              1001 10001
1000100010001              1001 10001
1000000010001              1111100011
1000100010001                   10001
1000111111D11111                11D11                1111111111
1000110000000001          11111100000111111          1000000001
1000110000000001          10000000000000001          1000000001
1000110000000001          1000000000000000111111111111000000001
1000010000000001          1000000000000000010000000001000000001
10000D0000000001          10000000000000000D000000000D000000001
1000010000000001          1000000000000000010000000001000000001
1000110000000001          1000000000000000111100001111000000001
1000110000000001          10000000000000001   1001   1000000001
1000110000000001          11111100000111111   1001   1000000001
1000111111D11111                11D11         1001    110110111
10001   10001                   10001         1001    1111111
1000111110001                   10001         1001
1000100010001                   10001         1001 111111111
1000000010001                   10001         1001 1010101011
1000100010001                   10001         100010000000001
1000111110001                   10001         1000D0000000001
1000111110001111111111111       10001         100010000000001
100000000000000001000000111     10001          11111010101011
10000000000000000D000000101     10001              111111111
100000000000000001000001111     10001
111111111111111111111111        10001
         111001001001      1111111D1111111
         101001001011      100001000100001
         11100000111       10000D000D00001
           11D1111         100001000100001
            1001           100001000100001
            1001           111111000111111
            1111           100001000100001
                           10N00D000D00001
                           100001000100001
                           111111000111111
                           100000000000001
                           100000000000001
                           100000000000001
                           111111111111111
