NO ./assets/normal_north.xpm
SO ./assets/normal_south.xpm
WE ./assets/normal_west.xpm
EA ./assets/normal_east.xpm

F 189,195,199
C 236,240,241

11111111
10000001
10100001
10000001
10000001
1000N001
10000001
11111111