NO ./assets/normal_north.xpm
SO ./assets/normal_south.xpm
WE ./assets/normal_west.xpm
EA ./assets/normal_east.xpm

F 189,195,199
C 236,240,241

1111111111
1111111111
1100000011
1100000011
1100000011
1100000011
11000N0011
1100000011
1111111111
1111111111